1111111111111111111111111111111111111111111111111111111111
1P0CC00000000000010000000000000000000000000000010000000001
1111111011111111010000000000101111111111111011011111000001
1000001010000001010000000000101000000000000010000001000001
1000001010100001010000000000101000000011111110011101000001
100000101010111101000000000010100000001C100010010101000001
1000001010111000010000000000101000000010100010010101110001
1000001C10000001010000000000101000000010111010010100010001
10000111111111010100000000001010000M0010101010010101010001
1000010000000101011111111111101111111110101010010101010001
1000010111110101000000000000000000000000001010010101010001
1011110000010111111111111111111111111111111010010101011101
10100000000100000000000000000000001M100000001001010100C101
1010111100011111101000000000000000101000000010010101011101
101001M100000000101000000000000000101000000010010101010001
1011010111111111101111111101110000101111111110010100010001
10010100000000000000000000000100001C000C000000010101110001
1001011111111111111111111111010000111111111111010101000001
1001010100000100000010000011011111100000000001010101000001
100100010111C101111010101110000000100000000001C10101000001
1001110101011101001011100011111101111100000001110101000001
100001010000000100000000000000010000E100000000010101000001
1000010111111101111111111111111111111111111111110101000001
1000010000000000000000000000000000000000000011100101000001
1000011101111111111111111101111111011111111001110101000001
10000001010000010101C0000101000001000000001000100101000001
1000000101000001000111100100010111111111101000000101000001
1010010101000001110000000101010000000000101111110101000001
1011010101000000010110111101111111111110100000010101111111
10101101010000000101C0100000000000000010111011010100000001
1010010101110000010111101111111111111010001001010101111101
1000000100010000010000101000000000001011101101010101000101
1000000111010000011110101000000000001000111C0101010101C101
1000000001011111000010101000000000001101101111111101011101
1010010001010001110010101000000000000100100000000001000101
1010100001010100010010101110000011110110101110111111110101
1011000001000101010010100C10000010M10100101110000000000001
1010100001111101010010111110000010111101101111111111111111
1010010000000101010010001000000010000000101111010000000001
1000000000000111010011101000000010111111101111011101111001
1000001110000001010000101000000010000000000000000001101101
1000001010001111011110101000000010111111111111111111001001
1000001010001000000010101000000010000000000000010000011101
1000001011111000000010101110111011111111111011010111111001
10000010000000000000101000101C1000000000001010010000000001
1000001001111111111110001010101000000000001010110111111101
1000001100000000000010101010101000000000001010C10100000101
1000000101111111101111101011101000000000001011110100000101
1000000100000010100000001000001000000000000000000100000101
1111111111111111111111111111111111111111111111111111111111
